NO ./textures/north.xpm
SO ./textures/south.xpm
WE ./textures/west.xpm
EA ./textures/east.xpm

F 220,100,0
C 225,30,0
        
        1111111111111111111111
        1000000000110000000001
        1011000001110000000001
        1001000000000000000001
11111111101100000111000000000011111
1000000000110000011101111111111
1111011111111101110000001000111
11110111111111011101010010001
11000000110N01011100000010001
10000000000000001100000010001
10000000000000001101010010001
1100000111010101111101111000111
1111011111110101101111111011101
1111111111111111111111111111111