SO ./textures/a.xpm 
EA ./textures/b.xpm
F 1,250,57
NO ./textures/c.xpm
WE ./textures/d.xpm
           
C 25,21,0


1111111111111111111111111111111111
1111110000000001110000000000001111111
100000000000000000000000001111111111111
100000000000000000000000001111111111111
100001000011111111000000011110011111111
100000000000000000000E000011111111111111
100000000001110000000000001100111111111
100000000000000000000000001111111111111
100000100000000000001111111111111111
111111111111111111111111111111111













