                        NO                              ./textures/north.xpm
SO ./textures/south.xpm
WE ./textures/west.xpm


EA ./textures/east.xpm
           
F       1,2,3 


C       225,30,0




        1111111111  1111111111
        1000000000110000000001
        1011000001110000000001
        1001000000000000000001
11111111101100000111000000000011111
100000000011000001101111111111
1111011111 1111111000001000111
 1110111111111011101010010001
11000000110N01011100010010001
100000000000000011001 1010001
10000000000000001101010010001
100000111010101111101111000111
11110111 1110101101111111011101
1111111111111111 11111111111111

