SO ./textures/a.xpm 
EA ./textures/b.xpm
F 1,250,255
NO ./textures/c.xpm
WE ./textures/d.xpm
           
C 25,21,0


111111111111111111111111111111111111111111111111111111111111111111111111111111111111
10000000000000000000000000000000000000S000000000000000000000000000000000000000000001
100000000000000000000000000000000000000000000000000000000000000000000000000000000001
100000000000000000000000000000000000000000000000000000000000000000000000000000000001
100000000000000000000000000000000000000000000000000000000000000000000000000000000001
11111111111111111111111111111111111111111111111111111111111111111111111111111111111111111111
1
1
1









