SO ./textures/a.xpm 
EA ./textures/b.xpm
NO ./textures/c.xpm
WE ./textures/d.xpm
           
F 1,250,255
C 25,21,0


111111111111111111111111111111111111111111111111111111111111111111111111111111111111
100000000000000000000000000000000000000000000000000000000000000000000000000000000001
100000000000000000000000000000000000000000000000000000000000000000000000000000000001
1000000000000000000000000000000000000000N0000000000000000000000000000000000000000001
100000000000000000000000000000000000000000000000000000000000000000000000000000000001
111111111111111111111111111111111111111111111111111111111111111111111111111111111111


